11
11101112001
00100011101
00111000011
11111111111
00000110101
11010110101
01111100101
00000100101
01110100101
01310100101
01110100111