13
0001111011000
1001010003010
0110110010100
1111100011110
1001101100110
1111111101000
1100000111010
0000100010100
1100000111000
0110101101000
0001111211010
0010010000100
0011010001110
