31
0011110111011011001111010101110
0110111001010010010010000000010
1111100010101100000000000000100
1111001100001111000000000001000
1010001110000000100000000001000
0101010010101100010110000000000
0010111001001010000000001010000
1111010111010000000000000000000
1010100100001010100000100000000
1101100001110000000000000100000
1010010000110001100000001000000
0103100101000001000100000000000
1001101010101000001000011000000
1110010110100100010000000000000
1110101100000000101000100000000
1111010001100001000000010000000
1010000000010010000001010000000
0001001100000100101000000000000
1010001010000001000000100000000
1111110000010001010000000000000
1000100001101000000100100000000
0101111001000001000001000000000
1020000010000110001000000000000
1110100100010000010000000000000
1100001010000000100011000000000
1110010110000010000001000000000
1111100100100010100000000000000
1001010011011000000100000000000
1000000010101001000010000000000
1110010001000101100000000000000
1010101000000010000010000000000
