15
010001010110001
100000111111110
001010010000100
111100111010000
110010000010000
100100110100000
211010111011000
010101010101110
111000110000100
100001001011010
000011010011110
001001000110100
011001000111000
010111111011010
101111100131100
