13
1121011100110
0010100001000
1100010100010
0100011101110
1010001010110
1100001010000
0100000001010
1001010001110
0011011111010
1011111001110
1111001100100
1111300011000
0101001110110
