61
0000100011001010110001100011111100010010100111010001010001010
0001100011011110100000010111100100111010101100100000001110110
1010001000010110001010010110111101001011101101001100000100100
1111000011010100001110001110010001110110001001001011000011110
0011111100001110000101011100001001111011000011100110010111100
1001000010010011000110001011100110111101000001110110000110110
1101100100100010011110000110001110011110110101111000110110000
1011000011011101011101100010111010000001001100111010011101000
1000011000000100001101111001110101111000001000100000111101100
0110011011101001101010000011010001100110001001111001001101000
0010000000011111010100011101100111111000011011010100011100100
0101001011000101111100101111100001101011001001011111001010100
0100110001100011110000000100100100100011000100000000110000000
1101000111110110011011100110011000111101100100011100001011110
1111111111110011111001100010011000010100110000001001001101000
1011100001000100110111011100000000100100010111100100101110010
0110010100100010011010101101000101110100001010010100101011000
0110001110010110110001010011100010111011000100110010100011110
0100000111110111010000000110011001111100001100101001001000010
1100110111011111000100011000011101011010111110111000101001010
1100100000101010100100010111111000110000001001010011011011100
0010100000111101101001110010001010110000010111001100000010010
1000011000000101101011010010100010111100100010011111001101100
1010011100000000100000010110010101000101000011000101010111010
1100111101010000001001011010001010110101100100100011001011010
1110000110001110101110010100101100001111101000001000101110100
1011001001101001101110110001100000111001100010101111001011110
0111111111110001101001010011011100111010000100000101100110100
0101100010000011101111001111001010111110011100000101010101000
0010111101000010111100100000110011110100101010101101111100010
0110010010100010001001010000111111011110110111000001010000010
0100111000100001011100010100001101001110100011101100110011110
0101110000001101011110110101101111001101101100000101001101000
1000100101000100110000111010111110101110111100100111000011100
0000100110011010130100001110010001100111101111101000000111000
1001011011010010101000110000100101111101001001010100101101110
1100000100110101100101111100001111001100000011000011011111100
1101101101110100010100111010000100110111010000101001011101000
0101101100001011100100001111110000110100101101101111111010100
0111111101001001001001100101000101011110101001110010001000110
0100101001101100010110000001011111011001000000101100100110000
1110010010100001111100011110110101010110010101100001001101000
0001010000100111011110010101001110111111011111001011110011000
0101101101010111011001101011100100001111111001001101000000010
1100000001110001001001101000001011010000110011111011111010110
0010011010100000010010111101011001010001101110101111000100000
1111010010000100010100101000101001110010000111001010001111100
0111011010100110001111010011111000111110001110100000000101010
0000001001011111100111000110101110001011000111000010000100110
0101000001011000110111010010111010010010011111111010100011110
0000010001111110101110102000001101000100101100011100001110100
0110000000100000000110111010110011101011001110001100101110010
0111000110101101110111011001011000111111001011010111010100000
0101011100010011011100000011010101101100110100110000111101010
0110111001000100100101001111110001111100010010010011010100110
0011011001000101001011000110111101111100111011100010110111000
1110000100111011100010010111110101110000100110111101100010110
1111011111010011101001000100001010110110000111001011000011110
1011001011001010100001011110111110011101001011011001000000010
1101111010101010100111101111101000110101111010111011000000010
1111010110110011011010110110000100001110100011001110001011100
