61
0011000111101111000110110001011000101100110101101101100010110
0001101110010100110111000110010010001010011111011010101000110
1110000111101010010110011011000011100110010001101101001000010
1110110011111010100011101011000101100101000001000001001101110
0010000101100010011101000010000111110000001001110101111100000
0101010001100011010001010010101100111100100000001101100010000
1001100011111110000101110011110110011010001110001110101010000
0000201001100101011110000110110110110010101011101000010111110
1111101000001110000100010001011000010111000001110001101110000
1111001100101100101001010010111111010010100101011001001100100
0001010100001001000001111001001111111111110100100000001111000
1110110010111001100000110010010110111000010000111101000111110
1010001100100110100000001101100001000001001010101100101011010
1101000100110010000111001100100101010001001011110000011011000
1100011001000000011100010010000001001000110100010100111110000
0100111101101100000011101010011101011001011101000011011011110
0001000000010010011011101001101101000001001011000111111011010
1001101011001101100000011010010010111011001100000010001013100
1110001000100101001100101001011111001110101010101110010100100
0110011001010101111001001010011100000100011111000111101001100
1100001111110001011010011001000110001101111010100101001001110
0100010111000000101010000000010010000110000000101101100001010
1001011010101011101000111010111000100100011010111010011000010
1011010001001001011101101001001010000101111010110011100001110
0101000001101010010011001000011011011000100000001001000110100
1011010101010110011010010101111111111110110010101000111010110
0010000100101000111101000111011101111011101111011110000010010
1011111110100100011001000100011100001000010101100010110010100
0100100010011101111000010111001110010100010010001110110100010
1001001000001000110111101101110101100101101000011010101100100
0001111011010011110101010110111111010110010110111010000010110
1110001101110100111100011100010101110100010100010010110110010
1000100101000001000100110011110110011000101001011010100110000
1110100011001111011011111011010011011101011011011111001011110
0111001000001110001010100100101111011000001111111100001011000
0011011111100000101000100100110001110010010001001101001110010
0010101001011011111011000000110111010001101110101110100001100
0000110001110100000000100001011100011001011110100100011111000
0010110000110011111011101011010011100101111101010111010010000
1011010011001110100010001101100100010101100011110101110110110
0000010001001000010010101111001101000100110000110000011101000
0011010010000000100011010011101101111000000011000011000010000
1111100001010100010010011010111100111001101010011010110111100
0011100101011010110011001010110100000011101100001010010000110
1000100001010110110110000101010110010000111000100000000001000
0001001011100111110001010010001110001010110110100111100101010
0110011101000110100011011010001111011010111100100110101001110
0111010011010000011101100001101001110101111011111001000100110
1001011000001110110001111111001001001110011011010010001100010
1010001111111010010011011100000000101010011011000100010111100
0000100001000011000100111110001011101000100101110001100100110
0010011001101011101001110111001111010101010001111101001110100
1010000110100001101010110011000000010110100011101011010010110
0001001001010001101110001100111000111100100110101100111000000
1101101001100110110111000110100011011111101111010011011111110
1011010000001010111100000000101111001100010001010111010101010
0011101101010000010100000001111001010111001100011101101011010
0011000100011011101001010110010110001101111100101001101000100
0001110001100001101000000101001000101101001011110101001001110
1100100111000111010001011000100101011100111011011001111000110
1001010101001100110100011101110001101101000111111000110110110
