61
0100100010101000101000110100110110011010110100000011010110010
0101001011100001101010100000110000110100011110011001100000110
1101100000111100011000100101001111011100001010100100110100110
0110010101111000001011111110100101101111101101010010011110100
1000100101100011011011100011111010000101100110110010010110000
1110101011010000010111010001011110010100000101111000011000000
1110100100001101010000011001000100000001010010100101110011010
1101110001010110110110101101101110010001000010100101110110000
1101000000101000010110000000010001011011001101001111100100010
1010011010010010010010000101001001010000000000101000101011000
1010110100100111010001110011100110011011001000100011011001100
0101011011011110101111011000011010010111011011101011100000110
0110010010111010011000001100010101111111101001001111111111100
1101100110101011001101010100000000111101110001010100111000110
1100000011001001100101101100010010110101001100110100101010000
0011011101100100010001011001101101001000110011111010110101010
1000000101001000000101111000000010111011011010110100001110100
0010100101100010000100101100111110000011110010111111000000010
0110101011110100101010111111000110101100011011011011010000000
1000001110010110101010001000010100100111101000010010011010100
1111001111010010100010001001010100100010001110101100101101000
1001101011011110111001000100100010100111001010100000101111000
0100010101001001000101000000111010101100111000110101100000000
1011010111010000000000110111011111111100111001110000001111000
1101001111001010011001001000011000000100101010010101011110000
1210000101110101011110000010011110101111101100110100010011110
0100010101110010010011110111110010100000000000011100300001010
0010010101110100001101001011000011011100011111001010101001000
1110101001011110100100001101101110011110001000111100010000000
1000110101110101001111100101111101111111101011001000011000110
1101011110100111001001101011101000110110110111111001111010100
1010011010101101010110001101000111111111010000010101101111010
0001010011100001001000011100000100001010100010101001010110000
0000000101010110110011000111000111101001111110100011111101110
1001010110011111110101000111010101001100010110010111000010100
1111110011110101111011000111011010001001001100001110000101000
1100011011011010101101000011010110110010011111001000011101110
0001111001111000001010101000110101011011100001100101001100110
1101101001010001110100110001101000011001100100010010010100000
1001001111010011101101001000110101000001101100100000111000010
0100100101000101010011110100101011001001111111100111000011000
1110000000100111100111011011000101000011110101101101111100000
1100110100101111101001111001101010111111101010010110100110110
1001000010010110100010010000101010110100111001011001001001100
0000100101000110100100100111111100001101000101000010010010100
1101010011000101110110000101011111111000000001011000001001010
0000111110100011011011101111011100111101100101011010011011100
0010100111101101110010110110000000110010100101001000010011100
1000000011010100111001100010100011110011101101000000010111000
1111101100011010011001110010111001111010111100110111010000010
1010111000011001010101100000100101011100000001110011010010010
0111100101101110111010001100000000000100100100100100001001000
1101110110111001101110111111100110011011001000111001000011110
0111000101000110110101001001100100101011111010100111100000000
0000101011011101110101100110100100001011001000011111001010010
0100001101000100100000100010010000110000101010100100010101110
1101110010110010100101111100100001100001110000010010111110110
0011111110111010010000111111100000100011111000001011000101000
0111011101001011010001001100011100001101000010000100000001110
0110110000011111000001000100111001010001000101000101111010000
1111101001101001101110111011100111000101011010110010011110000
