21
100010000001010010100
110011101100000100000
010001100111110011010
000010111100110011100
010101111010000010000
000111010101100100110
010000010010010101010
110000010000010100100
101000001110101000110
000001131010001000000
001111111111101100010
010001001111001010100
010000010111001100000
000100000100000111110
001100110011000010000
000200110101111001100
000101010000010111100
000010000010011011100
101011000111001101000
100111110001001101000
101111110010111100010
