17
11010101110000111
10101110111010110
00101000110100110
00111100100000000
00011010101011110
01110010111110010
01011111000100000
00001111001001000
01011110110010100
00111110011111000
10100010111010010
10101110001100110
10100100110101100
01110000110101010
10110010111110000
01000020001101100
01100000000011010
