15
111101000010110
101110100010110
101011000010100
011001110110010
111101100111100
001100110001010
001011010000000
111001100101000
001110000110020
000001010001000
000111011000100
111111011010010
000000311000010
111010101011010
110110101011100
